{
  "id": "almshouse-small",
  "width": 32,
  "height": 22,
  "tiles": [
    "################################",
    "#...........#..................#",
    "#...........#..................#",
    "#...........#..................#",
    "#...........#..................#",
    "#####D############D#############",
    "#..............................#",
    "#..............................#",
    "#..............................#",
    "#####D############D#############",
    "#...........#..................#",
    "#...........#..................#",
    "#...........#..................#",
    "#...........#..................#",
    "#...........#..................#",
    "###############D################",
    "#..............................#",
    "#..............................#",
    "#..............................#",
    "#..............................#",
    "#..............................#",
    "################################"
  ],
  "rooms": [
    { "id": "womens-ward", "type": "bedroom", "label": "Women's Ward", "x": 1, "y": 1, "w": 11, "h": 4 },
    { "id": "mens-ward", "type": "bedroom", "label": "Men's Ward", "x": 13, "y": 1, "w": 18, "h": 4 },
    { "id": "corridor", "type": "corridor", "label": "Corridor", "x": 1, "y": 6, "w": 30, "h": 3 },
    { "id": "restraints-cell", "type": "cell", "label": "Restraints Cell", "x": 1, "y": 10, "w": 11, "h": 5 },
    { "id": "dining-hall", "type": "dining", "label": "Dining Hall", "x": 13, "y": 10, "w": 18, "h": 5 },
    { "id": "garden", "type": "garden", "label": "Garden", "x": 1, "y": 16, "w": 30, "h": 5 }
  ]
}
